150 150
333333333333333333333333333333333333333333333333333333333333333333322222222222223222222233233333333202222222222211111111111111111111111111122222222222
333333333333333333333333333333333333333333333333333333333333233333222222222222222222222223333333333202222222222221112111111111111111111111122222222222
333333333333333333333333333333333333333333333333333333333323232322222222222222222222222222333333333202222222222222221111111111111111111111222222222222
333333333333333333333333333333333333333333333333333333333222233322222222222222222222222222333333332202222222222222222111111111111111111111222222222222
333333333333333333333333333333333333333333333333333333233222223222222222222222222222222222332333322202222222222222222211111111111111111112222222222222
333333333333333333333333333333333333333333333333333333223222222222222222222222222222222222223333322202222222222222222211111111111111111222222222222222
333333333333333333333333333333333333333333333333333333233322222222222222222222222222222222223233322202222222222222222221111111111111122222222222222222
333333333333333333333333333333333333333333333333333332223222222222222222222222222222222222222222222202222222222222222221111111111112222222222222222222
333333333333333343433333433333333333333333333333333322222222222222222222222222222222222222222222222202222222222222222222111111122222222222222222222222
333333333333333334333333333333333333333333333333333332222222222222222222222222222222222222222222222202222222222222222222221222222222222222222222222222
333333333333333334343333333333333333333333333333333333222222222222222222222222222222222222222222222202222222222222222222222222222222222222222222222222
333333333333333333334333333333333333333333333333333332222222222222222222222222222222222222222222222202222222222222222222222222222222222222222222222222
333333333333333334444333333333333333333333333333333332222222222222222222222222222222222222222222222202222222222222222222222222222222222222222222222222
333333333333333343343333333333333333333333333333333333222222222222222222222222222222222222222222222202222222222222222222222222222222222222222222222222
333333333333333333333333333333333333333333333333333333222222222222222222222222222222222222222222222202222222222222222222222222222222222222222222222222
333333333333333444333333333333333333333333333333333333222222222222222222222222222222222222222222222202222222222222222222222222222222222222222222222222
333333333333444444433333333333333333333333333333333332222222222222222222222222222222222222222222222202222222222222222222222222222222222222222222222222
333333333333333443333333333333333333333333333333333332222222222222222222222222222222222222222222222202222222222222222222222222222222222222222222222222
333333334434333333333333333333333333333333333333333332222222222222222222222222222222222222222222222202222222222222222222222222222222222222222222222222
433333334443433333333333333333333333333333333333333333222222222222222222222222222222222222222222222202222222222222222222222222222222222222222222222222
433343444443433333333333333333333333333333333333333333322222222222222222222222222222222222222222222202222222222222222222222222222222222222222222222222
434444444444333333333333333333333333333333333333333333322222222222222222222222222222222222222222222202222222222222222222222222222222222222222222222222
444444444333333333333333333333333333333333333333333333322222222222222222222222222222222222222222222202222222222222222222222222222222222222222222222222
334444444333333333333333333333333333333333333333333333332222222222222222222222222222222222222222222202222222222222222222222222222222222222222222222222
334444444333333333333333333333333333333333333333333333332333322222222222222222222222222222222222222202222222222222222222222222222222222222222222222222
334444444333333333333333333333333333333333333333333333333333332222222222222222222222222222222222222202222222222222222222222222322222222222222222222222
334434433333333333333333333333333333333333333333333333333333333222222222222222222222222222222222222202222222222222222222222233333222222222222222222222
334444433333333333333333333333333333333333333333333333333333333222222222222222222222222222222222222202222222222222222222222333333322222222222222222222
334443333333333333333333333333333333333333333333333333333333333322222222222222222222222222222222222202222222222222222222223333333333322222222222222222
434443333333333333333333333333333333333333333333333333333333333322222222222222222222222222222222222303333333322222222222233333333333332222222222222222
444433333333333333333333333333333333333333333333333333333333333322222222222222222222222222222222222303333333333332333323233333333333333222222222222222
444433333333333333333333333333333333333333333333333333333333333322222222222222222222222222222222223303333333333333333233333333333333333222222222222222
444433333333333333333333333333333333333333333333333333333333333322222222222222222222222222222222233303333333333333333333333333333333333322222222222222
444444333333333333333333333333333333333333333333333333333333333333222222222222222222222222222222233303333333333333333333333333333333333332222222222222
444444434333333333333333333333333333333333333333333333333333333333322222222222222222222222222222233303333333333333333333333333333333333322222222222222
444444444444333333333333333333333333333333333333333333333333333333323222222222222222222222222222233303333333333333333333333333333333333333222222222222
444444444444433333333333333333333333333333344333333333333333333333333323332222222222222222222222233303333333333333333333333333333333333333322222222222
444444444444444333333333333333333333333333444333333333333333333333333333333222222222222222222222333303333333333333333333333333333333333333322222222222
444444444444444433333333333333333333343444443343333333333333333333333333333222222222222222222222233303333333333333333333333333333333333333322222222222
444444444444444443333333333333333333344444444444333333333333333333333333333222222222222222222223333303333333333333333333333333333333333333322222222222
444444444444444444444333333333333333344444444444444333333333333333332233333322222222233222222233333303333333333333333333333333333333333333322222222222
444444444444444444444433333333333333444444444444444433333333333333322233332222222222323222232233333303333333333333333333333333333333333333322222222222
444444444444444444444433333333333333444444444444444443333333333333332223322222222222322223333333333303333333333333333333333333333333333333322222222222
444444444444444444444433333333333333344444444444444433333333333333332232222332222222222223333333333303333333333333333333333333333333333333332222222222
444444444444444444444433333333334444344444444444444433333333333333333233233333322222222223333333333303333333333333333333333333333333333333333222222222
444444444444444444444444443333333444444444444444444433333333333333333333233333322222222333333333333303333333333333333333333333333333333333333332222222
444444444444444444444444444444333444444444444444444443333333333333333333333333332232233323333333333303333333333333333333333333333333333333333332222222
444444444444444444444444444444433344444444444444444444333333333333333333333333333333333333333333333303333333333333333333333333333333333333333333322222
444444444444444444444444444444443444444444444444444444433333333333333333333333333333333333333333333303333333333333333333333333333333333333333333332222
444444444444444444444444444444444444444444444444444444443333333333333333333333333333333333333333333303333333333333333333333333333333333333333333332222
444444444444444444444444444444444444444444444444444444443333333333333333333333333333333333333333333303333333333333333333333333333333333333333333333322
444444444444444444444444444444444444444444444444444444444333333333333333333333333333333333333333333303333333333333333333333333333333333333333333333333
444444444444444444444444444444444444444444444444444444444333333333333333333333333333333333333333333303333333333333333333333333333333333333333333333333
444444444444444444444444444444444444444444444444444444444333333333333333333333333333333333333333333303333333333333333333333333333333333333333333333333
444444444444444444444444444444444444444444444444444444444333333333333333333333333333333333333333333303333333333333333333333333333333333333333333333333
444444444444444444444444444444444444444444444444444444444433333333333333333333333333333333333333333303333333333333333333333333333333333333333333333333
444444444444444444444444444444444444444444444444444444444433333333333333333333333333333333333333333303333333333333333333333333333333333333333333333333
444444444444444444444444444444444444444444444444444444444444433333333333333333333333333333333333333303333333333333333333333333333333333333333333333333
444444444444444444444444444444444444444444444444444444444444433333333333333333333333333333333333333303333333333333333333333333333333333333333333333333
444444444444444444444444444444444444444444444444444444444443433333333333333333333333333333333333333303333333333333333333333333333333333333333333333333
444444444444444444444444444444444444444444444444444444444434333333333333333333333333333333333333333303333333333333333333333333333333333333333333333333
444444444444444444444444444444444444444444444444444444444444333333333333333333333333333333333333333303333333333333333333333333333333333333333333333333
444444444444444444444444444444444444444444444444444444444444333333333333333333333343334333333333333303333333333333333333333333333333333333333333333333
444444444444444444444444444444444444444444444444444444444333334333333333333333333444443333333333333303433333333333333333333333333333333333333333333333
444444444444444444444444444444444444444444444444444444433333334443334333333333344434444433333334443403433333333333333333333333333333333333333333333333
444444444444444444444444444444444444444444444444444444443333333333333433333333333444444444433333444404433333333333333333333333333333333333333333333333
444444444444444444444444444444444444444444444444444434333333333444343433333333333344444444433334444403433333333333333333333333333333333333333333333333
444444444444444444444444444444444444444444444444444444333333333334444333333333333333344444443444444404433333333333333333333333333333333333333333333333
444444444444444444444444444444444444444444444444444344443333333344434333333333333333344444444333434404333333333333333333333333333333333333333333333333
444444444444444444444444444444444444444444444444433344434333333333434333333333333333333444333333334404434433333333333333333333333333333333333333333333
444444444444444444444444444444444444444444444444333344444333333333433333333333333333333344333333334404444433333333333333333333333333333333333333333333
444444444444444444444444444444444444444444444443333333344333333343334333333333333333333333333333333404444333333333333333333333333333333333333333333333
444444444444444444444444444444444444444444444433333333334333333333334433433333333333333333333333333404444433333333333333333333333333333333333333333333
444444444444444444444444444444444444444444444433333333333333333333333333333333333333333333333333333304333433333333333333333333333333333333333333333333
444444444444444444444444444444444444444444444433333333333333333333333333333333333333333333333333333303333333333333333333333333333333333333333333333333
444444444444444444444444444444444444444444443333333333333333333333333333333333333333333333333333333303333333333333333333333333333333333333333333333333
444444444444444444444444444444444444444444443333333333333333333333333333333333333333333333333333333403333333333333333333333333333333333333333333333333
444444444444444444444444444444444444444444443333333333333333333333333333333333333333333333333333334303333333333333333333333333333333333333333333333333
444444444444444444444444444444444444444444433333333333333333333333333333333333333333333333333333444303333333333333333333333333333333333333333333333333
444444444444444444444444444444444444444444433333333333333333333333333333333333333333333333333333433303333333333333333333333333333333333333333333333333
444444444444444444444444444444444444444444333333333333333333333333333333333333333333333333333333433303333333333333333333333333333333333333333333333333
444444444444444444444444444444444444444443333333333333333333333333333333333333333333333333333333333303333333333333333333333333333333333333333333333333
444444444444444444444444444444444444443333333333333333333333333333333333333333333333333333333333333303333333333333333333333333333333333333333333333333
444444444444444444444444444444444444333333333333333333333333333333333333333333333333333333333333333303333333333333333333333333333333333333333333333333
444444444444444444444444444444444443333333333333333333333333333333333333333333333333333333333333333303333333333333333333333333333333333333333333333333
444444444444444444444444444443333333333333333333333333333333333333333333333333333333333333333333333303333333333333333333333333333333333333333333333333
444444444444444444444444444433333333333333333333333333333333333333333333333333333333333333333333333303333333333333333333333333333333333333333333333333
444444444444444444444444444333333333333333333333333333333333333333333333333333333333333333333333333303333333333333333333333333333333333333333333333333
444444444444444444444444433333333333333333333333333333333333333333333333333333333333333333333333333303333333333333333333333333333333333333333333333333
344333344444444444444443433333333333333333333333333333333333333333333333333333333333333333333333333303333333333333333333333333333333333333333333333333
333333334333333444443333333333333333333333333333333333333333333333333333333333333333333333333333333303333333333333333333333333333333333333333333333333
333333333333443344333333333333333333333333333333333333333333333323333333333333333333333333333333333303333333333333333333333333333333333333333333333333
333333333334433333333333333333333333333333333333333333333333332222223333333333333333333333333333333303333333333333333333333333333333333333333333333333
333333333333333333333333333333333333333333333333333333333333322222222233333333333333333333333333333303333333333333333333333333333333333333333333333333
333333333333333333333333333333333333333333333333333333333333222222222222333333333333333333333333333303333333333333333333333333333333333333333333333333
333333333333333333333333333333333333333333333333333333333332222222222222233333332222223333333333333303333333333333333333333333333333333333333333333333
333333333333333333333333333333333333333333333333333333333332222222222222222232222222222333333333333303333333333333333333333333333333333333333333333333
333333333333333333333333333333333333333333333333333333333222222222222222222222222222222333333333333303333333333333333333333333333333333333333333333333
333333333333333333333333333333333333333333333333333332222222222222222222222222222222222232223333333303333333333333333333333333333333333333333333333333
333333333333333333333333333333333333333333333333333322222222222222222222222222222222222222223333333303333333333333333333333333333333333333333333333333
333333333333333333333333333333333333333333333333222222222222222222222222222222222222222222223333333303333333333333333333333333333333333333333333333333
333333333333333333333333333333333333333333333332222222222222222222222222222222222222222222222233333303333333333333333333333333333333333333333333333333
333333333333333333333333333333333333333333333332222222222222222222222222222222222222222222222223333303333333333333333333333333333333333333333333333333
333333333333333333333333333333333333333333333322222222222222222222222222222222222222222222222222333303333333333333333333333333333333333333333333333333
333333333333333333333333333333333333333333333222222222222222222222222222222222222222222222222222222303333322233333333333333333333333333333333333333333
333333333333333333333333333333333333333333333222222222222222222222222222222222222222222222222222222202222222222333333333333333333333333333333333333333
333333333333333333333333333333333333333333233222222222222222222222222222222222222222222222222222222202222222222222333333333333333333333333333333333333
333333333333333333333333333333333333333333322222222222222222222222222222222222222222222222222222222202222222222222233333333333333333333333333333333333
333333333333333333333333333333333333333333332222222222222222222111122222222222222222222222222222222202222222222222223333333333333333333333333333333333
333333333333333333333333333333333333333333222222222222222222111111111122222222222222222222222222222202222222222222222333333333333333333333333333333333
333333333333333333333333333333333333333333222222222222222222111111111112222222222222222222222222222202222222222222222233333333333333333333333333333333
333333333333333333333333333333333333333333222222222222222221111111111112222222221222222222222222222202222222222222222222223333333333333333333333333333
333333333333333333333333333333333333333333222222222222222211111111111111222222111112222212222222222202222222222222222222222233333333333333333333333333
333333333333333333333333333333333333333332222222222222222221111111111111122222111112222122222222222202222222222222222222222222333333333333333333333333
333333333333333333333333333333333333333222222222222222222221111111111111112212111112221121222222222202222222222222222222222222223333333333333333333333
333333333333333333333333333333333333332222222222222222222121111111111111111111111112222111122222222202222222222222222222222222222222333333333333333323
333333333333333333333333333333333333322222222222222222222221111111111111111111111112222111122222222202222222222222222222222222222222322233333333333323
333333333333333333333333333333333332222222222222222222222211111111111111111111111111122111122222222202222222222222222222222222222222222223333333333333
333333223333333333333333333333333322222222222222222222222221111111111111111111111121122111111222222201221222222222222222222222222222222233333333333333
223322323333333333333333333333333222222222222222222222222222111111111111111111111122111111111121221101111122222222222222222222222222222223333333333333
223323222333333333333333333333322222222222222222222222222211111111111111111111122221111121111111111101111122222222222222222222222222222222333333333333
233222333333333333333333333333322222222222222222222222222211111111111111111111121211111111111111111101111122222222222222222222222222222222333333333333
332323333333333333333333333332222222222222222222222222222211111111111111111111111111111111111111111101111112222222222222222222222222222222333333333333
333333333333333333333333333322222222222222222222222222222111111111111111111111111111111111111111111101111111222222222222222222222222222222223333333333
333333333333333333333333333222222222222222222222222222222211111111111111111111111111111111111111111101111111221112222222222222222222222222222323333333
333333333333333333333333333222222222222222222222222222222111111111111111111111111111111111111111111101111111111111222222222222222222222222222223333333
333333333333333333333333332222222222222222222222222222221111111111111111111111111111111111111111111101111111211111111222222222222222222222222222333333
333333333333333333333333322222222222222222222222222222211111111111111111111111111111111111111111111101111111111111111122222122222222222222222223333333
333333333333333333333333322222222222222222222222222222211111111111111111111111111111111111111111111101111111111111111122221111222222222222222223333333
333333333333333333333333322222222222222222222222222222111111111111111111111111111111111111111111111101111111111111111111111111222222222222222223333333
333333333333333333333333322222222222222222222222222222111111111111111111111111111111111111111111111101111111111111111111211111222222222222222222333333
333333333333333333333333322222222222222222222222222222111111111111111111111111111111111111111111111101111111111111111111111112222222222222222222333333
333333333333333333333333322222222222222222222222222222211111111111111111111111111111111111111111111101112111111111111111111112222222222222222222333333
333333333333333333333333222222222222222222222222222222211111111111111111111111111111111111111111111101112221111111111111111111222222222222222222222333
223333333333333333333332222222222222222222222222222222221111111111111111111111111111111111111111111101222221111111111111111111222222222222222222222333
222333333333333333333332222222222222222222222222222222221111111111111111111111111111111111111111111101222221111111111111111111222222222222222222222333
222233333333333333332222222222222222222222222222222222222111111111111111111111111111111111111111111101122222211111111111111111121222222222222222222233
222222222333333333322222222222222222222222222222222222222211111111111111111111111111111111111111111101222222221111111111111111221222222222222222222223
222222222223333333322222222222222222222222222222222222222221111111111111111111111111111111111111111101221112222111111111111111221222222222222222222222
222222222222233333222222222222222222222222222222222222222222211111111111111111111111111111111111111102221122222222111111111111222222222222222222222222
222222222222222332222222222222222222222222222222222222222222221111111111111111111111111111111111111102211112222222222111111111222222222222222222222222
222222222222222222222222222222222222222222222222222222222222212111111111211111111111111111111111111202221111222211211111111111222222222222222222222222
222222222222222222222222222222222222222222222222222222222222212111111111111111111111111111111111111202221111222222111221111112222222222222222222222222
222222222222222222222222222222222222222222222222222222222222211111111111111111111111111111111111111201111112121222111111112222222222222222222222222222
222222222222223222222222222222222222222222222222222222222222222111211111111121111111111111111111222102111112222222111111112222222222222222222222222222
222222222222223222222222222222222222222222222222222222222222222222221111112211111111111111111111111101111111212211221222222222222222222222222222222222
222222222222223222222222222222222222222222222222222222222222222222222222222211111111111111111111111101111111211112221222222222222222222222222222222222
222222222222222222222222222222222222222222222222222222222222222222222222222222122111111111111111111101111111111112222222222222222222222222222222222222
222222222222222222222222222222222222222222222222222222222222222222222222222222222111111111111111111101111111111112222222222222222222222222222222222222
222222222222222222222222222222222222222222222222222222222222222222222222222222222211111111111111111101111111111222222222222222222222222222222222222222
